NO ./path_to_the_north_texture
SO ./path_to_the_south_texture
EA ./path_to_the_east_texture
WE ./path_to_the_west_texture

F 220,100,0
C 225,10,0

1111111111
100011110011
10001  100011
100011110011
1000000000N1
111111111111