NO     textures/red.xpm
SO        textures/greyscale.xpm
EA  textures/eagle.xpm
WE     textures/west.xpm
F 110,100,10
C 150,150,250

1111111111
1000000001
1000N00001
1000000001
1111111111
