
NO ./textures/red.xpm
WE ./textures/purplestone.xpm
EA ./textures/eagle.xpm
SO ./textures/greyscale.xpm

F 110,100,10
C 200,30,20

111111111111111111111111111111111111111111111111
110101010101010101010101010101010101010101010111
110101010101010101010101010101010101010101010111
110101010101010101010101010101010101010101010111
110101010101111111111101010101110111011101010111
110101010101110101011101010101010101010101010111
110101010101110101011101010101110101011101010111
110101010101110101011101010101010101010101010111
110101010101111101111101010101110111011101010111
110101010101010101010101010101010101010101010111
110101010101010101010101010101010101010101010111
110101010101010101010101010101010101010101010111
110101010101010101000011010101010101010101010111
110101010101010101010101010101010101010101010111
110101010101010101010101S10101010101010101010111
110101010101010101010101010101010101010101010111
111111111111111111010101010101010101010101010111
111101110101010111010101010101010101010101010111
111101010101110111010101010101010101010101010111
111101110101010111010101010101010101010101010111
111101111111111111010101010101010101010101010111
111101010101010101010101010101010101010101010111
111111111111111111010101010101010101010101010111
111111111111111111111111111111111111111111111111