NO  textures/red.xpm
SO  textures/greyscale.xpm
EA  textures/eagle.xpm
WE  textures/west.xpm
F 110,100,10
C 150,150,250

111111111
100000001
1000N0001
100000001
111111111