NO textures/red.xpm
WE textures/purplestone.xpm
EA textures/eagle.xpm
SO textures/greyscale.xpm

F 110,100,10
C 200,100,100

111      
101     111
1011    101
10001   101
100011111011
100000000001111111
100000000000000001
100000N00001111111
100000000001
100000000001
101111111011
101     101
101     101
1011    111
11111