
NO ./textures/red.xpm
WE ./textures/purplestone.xpm
EA ./textures/eagle.xpm
SO ./textures/greyscale.xpm

F 110,100,10
C 200,30,20


101

11   111
11111111111111111111111111
111111100N0000000000000001
      1000000000011111111
      10000000011
      11111111111



     1