NO textures/red.xpm
SO textures/greyscale.xpm
EA textures/eagle.xpm
WE textures/west.xpm

F 110,100,10
C 200,100,100

111111111111
100000000001111111
100000000000000001
100000N00001111111
100000000001
100000000001
111111111111



