NO ./textures/north.xpm        
SO ./textures/north.xpm
EA ./textures/north.xpm     
WE ./textures/north.xpm    

C 225,0,0
F 100,100,200

111
11N1
111
11111