F 100,100,200

C 100,100,200

NO ./textures/north.xpm


EA ./textures/east.xpm

SO ./textures/south.xpm
WE ./textures/west.xpm
111111
11N011
111111